AFG=Afghanistan
ALB=Albania
ATA=Antarctica
DZA=Algeria
ASM=AmericanSamoa
AND=Andorra
AGO=Angola
ATG=AntiguaandBarbuda
AZE=Azerbaijan
ARG=Argentina
AUS=Australia
AUT=Austria
BHS=Bahamas
BHR=Bahrain
BGD=Bangladesh
ARM=Armenia
BRB=Barbados
BEL=Belgium
BMU=Bermuda
BTN=Bhutan
BOL=Bolivia
BIH=BosniaandHerzegovina
BWA=Botswana
BVT=BouvetIsland
BRA=Brazil
BLZ=Belize
IOT=BritishIndianOceanTerritory
SLB=SolomonIslands
VGB=BritishVirginIslands
BRN=BruneiDarussalam
BGR=Bulgaria
MMR=Myanmar
BDI=Burundi
BLR=Belarus
KHM=Cambodia
CMR=Cameroon
CAN=Canada
CPV=CapeVerde
CYM=CaymanIslands
CAF=CentralAfrican
LKA=SriLanka
TCD=Chad
CHL=Chile
CHN=China
TWN=Taiwan
CXR=ChristmasIsland
CCK=Cocos(Keeling)Islands
COL=Colombia
COM=Comoros
MYT=Mayotte
COG=RepublicoftheCongo
COD=TheDemocraticRepublicOfTheCongo
COK=CookIslands
CRI=CostaRica
HRV=Croatia
CUB=Cuba
CYP=Cyprus
CZE=CzechRepublic
BEN=Benin
DNK=Denmark
DMA=Dominica
DOM=DominicanRepublic
ECU=Ecuador
SLV=ElSalvador
GNQ=EquatorialGuinea
ETH=Ethiopia
ERI=Eritrea
EST=Estonia
FRO=FaroeIslands
FLK=FalklandIslands
SGS=SouthGeorgiaandtheSouthSandwichIslands
FJI=Fiji
FIN=Finland
ALA=AlandIslands
FRA=France
GUF=FrenchGuiana
PYF=FrenchPolynesia
ATF=FrenchSouthernTerritories
DJI=Djibouti
GAB=Gabon
GEO=Georgia
GMB=Gambia
PSE=OccupiedPalestinianTerritory
DEU=Germany
GHA=Ghana
GIB=Gibraltar
KIR=Kiribati
GRC=Greece
GRL=Greenland
GRD=Grenada
GLP=Guadeloupe
GUM=Guam
GTM=Guatemala
GIN=Guinea
GUY=Guyana
HTI=Haiti
HMD=HeardIslandandMcDonaldIslands
VAT=VaticanCityState
HND=Honduras
HKG=HongKong
HUN=Hungary
ISL=Iceland
IND=India
IDN=Indonesia
IRN=IslamicRepublicofIran
IRQ=Iraq
IRL=Ireland
ISR=Israel
ITA=Italy
CIV=CÃ´ted'Ivoire
JAM=Jamaica
JPN=Japan
KAZ=Kazakhstan
JOR=Jordan
KEN=Kenya
PRK=DemocraticPeople'sRepublicofKorea
KOR=RepublicofKorea
KWT=Kuwait
KGZ=Kyrgyzstan
LAO=LaoPeople'sDemocraticRepublic
LBN=Lebanon
LSO=Lesotho
LVA=Latvia
LBR=Liberia
LBY=LibyanArabJamahiriya
LIE=Liechtenstein
LTU=Lithuania
LUX=Luxembourg
MAC=Macao
MDG=Madagascar
MWI=Malawi
MYS=Malaysia
MDV=Maldives
MLI=Mali
MLT=Malta
MTQ=Martinique
MRT=Mauritania
MUS=Mauritius
MEX=Mexico
MCO=Monaco
MNG=Mongolia
MDA=RepublicofMoldova
MSR=Montserrat
MAR=Morocco
MOZ=Mozambique
OMN=Oman
NAM=Namibia
NRU=Nauru
NPL=Nepal
NLD=Netherlands
ANT=NetherlandsAntilles
ABW=Aruba
NCL=NewCaledonia
VUT=Vanuatu
NZL=NewZealand
NIC=Nicaragua
NER=Niger
NGA=Nigeria
NIU=Niue
NFK=NorfolkIsland
NOR=Norway
MNP=NorthernMarianaIslands
UMI=UnitedStatesMinorOutlyingIslands
FSM=FederatedStatesofMicronesia
MHL=MarshallIslands
PLW=Palau
PAK=Pakistan
PAN=Panama
PNG=PapuaNewGuinea
PRY=Paraguay
PER=Peru
PHL=Philippines
PCN=Pitcairn
POL=Poland
PRT=Portugal
GNB=Guinea-Bissau
TLS=Timor-Leste
PRI=PuertoRico
QAT=Qatar
REU=RÃ©union
ROU=Romania
RUS=RussianFederation
RWA=Rwanda
SHN=SaintHelena
KNA=SaintKittsandNevis
AIA=Anguilla
LCA=SaintLucia
SPM=Saint-PierreandMiquelon
VCT=SaintVincentandtheGrenadines
SMR=SanMarino
STP=SaoTomeandPrincipe
SAU=SaudiArabia
SEN=Senegal
SYC=Seychelles
SLE=SierraLeone
SGP=Singapore
SVK=Slovakia
VNM=Vietnam
SVN=Slovenia
SOM=Somalia
ZAF=SouthAfrica
ZWE=Zimbabwe
ESP=Spain
ESH=WesternSahara
SDN=Sudan
SUR=Suriname
SJM=SvalbardandJanMayen
SWZ=Swaziland
SWE=Sweden
CHE=Switzerland
SYR=SyrianArabRepublic
TJK=Tajikistan
THA=Thailand
TGO=Togo
TKL=Tokelau
TON=Tonga
TTO=TrinidadandTobago
ARE=UnitedArabEmirates
TUN=Tunisia
TUR=Turkey
TKM=Turkmenistan
TCA=TurksandCaicosIslands
TUV=Tuvalu
UGA=Uganda
UKR=Ukraine
MKD=TheFormerYugoslavRepublicofMacedonia
EGY=Egypt
GBR=UnitedKingdom
IMN=IsleofMan
TZA=UnitedRepublicOfTanzania
USA=UnitedStates
VIR=U.S.VirginIslands
BFA=BurkinaFaso
URY=Uruguay
UZB=Uzbekistan
VEN=Venezuela
WLF=WallisandFutuna
WSM=Samoa
YEM=Yemen
SCG=SerbiaandMontenegro
ZMB=Zambia